{
  "Name": "Map 1",
  "Tileset": "tileMap.png",
  "TileAnimations": [
  {
	"ID": 1000,
    "Frames" : [ 121, 146, 171 ],
	"FPS": 5
  }
  ],
  "Width": 10,
  "Height": 10,
  "Layer1Data": [
	[157, 157, 157, 157, 157, 157, 157, 157, 157, 157],
	[157, 157, 157, 159, 157, 157, 157, 157, 157, 157],
	[157, 157, 157, 159, 159, 157, 157, 157, 157, 157],
	[157, 157, 157, 157, 159, 157, 157, 157, 157, 157],
	[157, 157, 157, 157, 157, 159, 159, 157, 157, 157],
	[157, 157, 157, 157, 157, 159, 157, 157, 157, 157],
	[157, 159, 159, 159, 157, 157, 159, 157, 157, 157],
	[157, 159, 157, 157, 157, 157, 157, 157, 157, 157],
	[157, 157, 157, 157, 157, 157, 157, 157, 157, 157],
	[157, 157, 157, 157, 157, 157, 157, 157, 157, 157]
  ]
}